1000 5 1
11111
10001
10101
10001
10101
10001
10101
10001
10101
10001
10101
10001
10101
10001
10101
10001
10101
10001
10101
10001
10101
10001
10101
10001
10101
10001
10101
10001
10101
10001
10101
10001
10101
10001
10101
10001
10101
10001
10101
10001
10101
10001
10101
10001
10101
10001
10101
10001
10101
10001
10101
10001
10101
10001
10101
10001
10101
10001
10101
10001
10101
10001
10101
10001
10101
10001
10101
10001
10101
10001
10101
10001
10101
10001
10101
10001
10101
10001
10101
10001
10101
10001
10101
10001
10101
10001
10101
10001
10101
10001
10101
10001
10101
10001
10101
10001
10101
10001
10101
10001
10101
10001
10101
10001
10101
10001
10101
10001
10101
10001
10101
10001
10101
10001
10101
10001
10101
10001
10101
10001
10101
10001
10101
10001
10101
10001
10101
10001
10101
10001
10101
10001
10101
10001
10101
10001
10101
10001
10101
10001
10101
10001
10101
10001
10101
10001
10101
10001
10101
10001
10101
10001
10101
10001
10101
10001
10101
10001
10101
10001
10101
10001
10101
10001
10101
10001
10101
10001
10101
10001
10101
10001
10101
10001
10101
10001
10101
10001
10101
10001
10101
10001
10101
10001
10101
10001
10101
10001
10101
10001
10101
10001
10101
10001
10101
10001
10101
10001
10101
10001
10101
10001
10101
10001
10101
10001
10101
10001
10101
10001
10101
10001
10101
10001
10101
10001
10101
10001
10101
10001
10101
10001
10101
10001
10101
10001
10101
10001
10101
10001
10101
10001
10101
10001
10101
10001
10101
10001
10101
10001
10101
10001
10101
10001
10101
10001
10101
10001
10101
10001
10101
10001
10101
10001
10101
10001
10101
10001
10101
10001
10101
10001
10101
10001
10101
10001
10101
10001
10101
10001
10101
10001
10101
10001
10101
10001
10101
10001
10101
10001
10101
10001
10101
10001
10101
10001
10101
10001
10101
10001
10101
10001
10101
10001
10101
10001
10101
10001
10101
10001
10101
10001
10101
10001
10101
10001
10101
10001
10101
10001
10101
10001
10101
10001
10101
10001
10101
10001
10101
10001
10101
10001
10101
10001
10101
10001
10101
10001
10101
10001
10101
10001
10101
10001
10101
10001
10101
10001
10101
10001
10101
10001
10101
10001
10101
10001
10101
10001
10101
10001
10101
10001
10101
10001
10101
10001
10101
10001
10101
10001
10101
10001
10101
10001
10101
10001
10101
10001
10101
10001
10101
10001
10101
10001
10101
10001
10101
10001
10101
10001
10101
10001
10101
10001
10101
10001
10101
10001
10101
10001
10101
10001
10101
10001
10101
10001
10101
10001
10101
10001
10101
10001
10101
10001
10101
10001
10101
10001
10101
10001
10101
10001
10101
10001
10101
10001
10101
10001
10101
10001
10101
10001
10101
10001
10101
10001
10101
10001
10101
10001
10101
10001
10101
10001
10101
10001
10101
10001
10101
10001
10101
10001
10101
10001
10101
10001
10101
10001
10101
10001
10101
10001
10101
10001
10101
10001
10101
10001
10101
10001
10101
10001
10101
10001
10101
10001
10101
10001
10101
10001
10101
10001
10101
10001
10101
10001
10101
10001
10101
10001
10101
10001
10101
10001
10101
10001
10101
10001
10101
10001
10101
10001
10101
10001
10101
10001
10101
10001
10101
10001
10101
10001
10101
10001
10101
10001
10101
10001
10101
10001
10101
10001
10101
10001
10101
10001
10101
10001
10101
10001
10101
10001
10101
10001
10101
10001
10101
10001
10101
10001
10101
10001
10101
10001
10101
10001
10101
10001
10101
10001
10101
10001
10101
10001
10101
10001
10101
10001
10101
10001
10101
10001
10101
10001
10101
10001
10101
10001
10101
10001
10101
10001
10101
10001
10101
10001
10101
10001
10101
10001
10101
10001
10101
10001
10101
10001
10101
10001
10101
10001
10101
10001
10101
10001
10101
10001
10101
10001
10101
10001
10101
10001
10101
10001
10101
10001
10101
10001
10101
10001
10101
10001
10101
10001
10101
10001
10101
10001
10101
10001
10101
10001
10101
10001
10101
10001
10101
10001
10101
10001
10101
10001
10101
10001
10101
10001
10101
10001
10101
10001
10101
10001
10101
10001
10101
10001
10101
10001
10101
10001
10101
10001
10101
10001
10101
10001
10101
10001
10101
10001
10101
10001
10101
10001
10101
10001
10101
10001
10101
10001
10101
10001
10101
10001
10101
10001
10101
10001
10101
10001
10101
10001
10101
10001
10101
10001
10101
10001
10101
10001
10101
10001
10101
10001
10101
10001
10101
10001
10101
10001
10101
10001
10101
10001
10101
10001
10101
10001
10101
10001
10101
10001
10101
10001
10101
10001
10101
10001
10101
10001
10101
10001
10101
10001
10101
10001
10101
10001
10101
10001
10101
10001
10101
10001
10101
10001
10101
10001
10101
10001
10101
10001
10101
10001
10101
10001
10101
10001
10101
10001
10101
10001
10101
10001
10101
10001
10101
10001
10101
10001
10101
10001
10101
10001
10101
10001
10101
10001
10101
10001
10101
10001
10101
10001
10101
10001
10101
10001
10101
10001
10101
10001
10101
10001
10101
10001
10101
10001
10101
10001
10101
10001
10101
10001
10101
10001
10101
10001
10101
10001
10101
10001
10101
10001
10101
10001
10101
10001
10101
10001
10101
10001
10101
10001
10101
10001
10101
10001
10101
10001
10101
10001
10101
10001
10101
10001
10101
10001
10101
10001
10101
10001
10101
10001
10101
10001
10101
10001
10101
10001
10101
10001
10101
10001
10101
10001
10101
10001
10101
10001
10101
10001
10101
10001
10101
10001
10101
10001
10101
10001
10101
10001
10101
10001
10101
10001
10101
10001
10101
10001
10101
10001
10101
10001
10101
10001
10101
10001
10101
10001
10101
10001
10101
10001
10101
10001
10101
10001
10101
10001
10101
10001
10101
10001
10101
10001
10101
10001
10101
10001
10101
10001
10101
10001
10101
10001
10101
10001
10101
10001
10101
10001
10101
10001
10101
10001
10101
10001
10101
10001
10101
10001
10101
10001
10101
10001
10101
10001
10101
10001
10101
10001
10101
10001
10101
10001
10101
10001
10101
10001
10101
10001
10101
10001
10101
10001
10101
10001
10101
10001
10101
10001
10101
10001
10101
10001
10101
10001
10101
10001
10101
10001
10101
10001
10101
10001
10101
10001
10101
10001
10101
10001
10101
10001
10101
10001
10101
10001
10101
10001
10101
10001
10101
10001
10101
10001
10101
10001
10101
10001
10101
10001
10101
10001
10101
10001
10101
10001
10101
10001
10101
10001
10101
10001
10101
10001
10101
10001
11111
11111
