	NO    ./textures/ltouzal1.png
 SO ./textures/ltouzal1.png
	WE 	  	./textures/ltouzal1.png
	EA 	 	 	./textures/ltouzal1.png

F 			255, 255, 255
	C  			 	 	 0	,	0 , 0 	
        1111111111111111111111111
        1000000000110000000000001
        10110000011100S0000000001
        1001000000000000000000001
111111111011000001110000000000001
100000000011000001110111111111111
11110111111111011100000010001    
11110111111111011101010010001  
11000000110101011100000010001    
10000000000000001100000010001    
1000000000000000000011010100111    
11000001110101011111011110001111111111111111111111111111111111111111111111111111111111111111111111111111111111111111111111111111111111
11110111 1110101 101111010001    
11111111 1111111 111111111111   

